AED	UAE Dirham	
AFN	Afghani	؋
ALL	Lek	Lek
AMD	Armenian Dram	
ANG	Netherlands Antillian Guilder	ƒ
AOA	Kwanza	
ARS	Argentine Peso	$
AUD	Australian Dollar	$
AWG	Aruban Guilder	ƒ
AZN	Azerbaijanian Manat	ман
BAM	Convertible Marks	KM
BBD	Barbados Dollar	$
BDT	Taka	
BGN	Bulgarian Lev	лв
BHD	Bahraini Dinar	
BIF	Burundi Franc	
BMD	Bermudian Dollar (customarily known as Bermuda Dollar)	$
BND	Brunei Dollar	$
BOB	Bolivian Boliviano	$b
BOV	Bolivian Mvdol	
BRL	Brazilian Real	R$
BSD	Bahamian Dollar	$
BWP	Pula	P
BYR	Belarussian Ruble	p.
BZD	Belize Dollar	BZ$
CAD	Canadian Dollar	$
CDF	Congolese Franc	
CHF	Swiss Franc	CHF
CLP	Chilean Peso	$
CLF	Chilean Unidad de Fomento	
CNY	Yuan Renminbi	¥
COP	Colombian Peso	$
COU	Unidad de Valor Real	
CRC	Costa Rican Colon	₡
CUP	Cuban Peso	₱
CUC	Cuban Peso Convertible	$
CVE	Cape Verde Escudo	
CZK	Czech Koruna	Kč
DJF	Djibouti Franc	
DKK	Danish Krone	kr
DOP	Dominican Peso	RD$
DZD	Algerian Dinar	
EEK	Kroon	
EGP	Egyptian Pound	£
ERN	Nakfa	
ETB	Ethiopian Birr	
EUR	Euro	€
FJD	Fiji Dollar	$
FKP	Falkland Islands Pound	£
GBP	Pound Sterling	£
GEL	Lari	
GHS	Cedi	
GIP	Gibraltar Pound	£
GMD	Dalasi	
GNF	Guinea Franc	
GTQ	Quetzal	Q
GYD	Guyana Dollar	$
HKD	Hong Kong Dollar	$
HNL	Lempira	L
HRK	Croatian Kuna	kn
HTG USD	Gourde US Dollar	
HUF	Forint	Ft
IDR	Rupiah	Rp
ILS	New Israeli Sheqel	₪
INR	Indian Rupee	
INR BTN	Indian Rupee Ngultrum	
IQD	Iraqi Dinar	
IRR	Iranian Rial	﷼
ISK	Iceland Krona	kr
JMD	Jamaican Dollar	J$
JOD	Jordanian Dinar	
JPY	Yen	¥
KES	Kenyan Shilling	
KGS	Som	лв
KHR	Riel	៛
KMF	Comoro Franc	
KPW	North Korean Won	₩
KRW	Won	₩
KWD	Kuwaiti Dinar	
KYD	Cayman Islands Dollar	$
KZT	Tenge	лв
LAK	Kip	₭
LBP	Lebanese Pound	£
LKR	Sri Lanka Rupee	₨
LRD	Liberian Dollar	$
LSL	Lesotho Loti	
LTL	Lithuanian Litas	Lt
LVL	Latvian Lats	Ls
LYD	Libyan Dinar	
MAD	Moroccan Dirham	
MDL	Moldovan Leu	
MGA	Malagasy Ariary	
MKD	Denar	ден
MMK	Kyat	
MNT	Tugrik	₮
MOP	Pataca	
MRO	Ouguiya	
MUR	Mauritius Rupee	₨
MVR	Rufiyaa	
MWK	Kwacha	
MXN	Mexican Peso	$
MXV	Mexican Unidad de Inversion (UDI)	$
MYR	Malaysian Ringgit	RM
MZN	Metical	MT
NAD	Namibia Dollar	
NGN	Naira	₦
NIO	Cordoba Oro	C$
NOK	Norwegian Krone	kr
NPR	Nepalese Rupee	₨
NZD	New Zealand Dollar	$
OMR	Rial Omani	﷼
PAB	Panamanian balboa	B/.
PEN	Nuevo Sol	S/.
PGK	Kina	
PHP	Philippine Peso	Php
PKR	Pakistan Rupee	₨
PLN	Zloty	zł
PYG	Guarani	Gs
QAR	Qatari Rial	﷼
RON	New Leu	lei
RSD	Serbian Dinar	Дин.
RUB	Russian Ruble	руб
RWF	Rwanda Franc	
SAR	Saudi Riyal	﷼
SBD	Solomon Islands Dollar	$
SCR	Seychelles Rupee	₨
SDG	Sudanese Pound	
SEK	Swedish Krona	kr
SGD	Singapore Dollar	$
SHP	Saint Helena Pound	£
SLL	Leone	
SOS	Somali Shilling	S
SRD	Surinam Dollar	$
STD	Dobra	
SVC	Salvadoran Colón	₡
SYP	Syrian Pound	£
SZL	Lilangeni	
THB	Baht	฿
TJS	Somoni	
TMT	Manat	
TND	Tunisian Dinar	
TOP	Pa'anga	
TRY	Turkish Lira	TL
TTD	Trinidad and Tobago Dollar	TT$
TWD	New Taiwan Dollar	NT$
TZS	Tanzanian Shilling	
UAH	Hryvnia	₴
UGX	Uganda Shilling	
USD	US Dollar	$
UYU	Peso Uruguayo	$U
UYI	Uruguay Peso en Unidades Indexadas	$U
UZS	Uzbekistan Sum	лв
VEF	Bolivar Fuerte	Bs
VND	Dong	₫
VUV	Vatu	
WST	Tala	
XAF	CFA Franc BEAC	
XAG	Silver	
XAU	Gold	
XBA	Bond Markets Units European Composite Unit (EURCO)	
XBB	European Monetary Unit (E.M.U.-6)	
XBC	European Unit of Account 9(E.U.A.-9)	
XBD	European Unit of Account 17(E.U.A.-17)	
XCD	East Caribbean Dollar	$
XDR	SDR	
XFU	UIC-Franc	
XOF	CFA Franc BCEAO	
XPD	Palladium	
XPF	CFP Franc	
XPT	Platinum	
XTS	Codes specifically reserved for testing purposes	
YER	Yemeni Rial	﷼
ZAR	South African Rand	R
ZMK	Zambian Kwacha	
ZWL	Zimbabwe Dollar